10 10
10 10 10 10 10 10 10 10 10 10
10 41 41 41 41 41 41 41 41 10
10 41 10 10 10 10 41 41 41 10
10 41 10 41 41 41 41 41 41 10
10 41 10 41 41 41 41 41 41 10
10 41 10 10 10 10 41 41 41 10
10 41 41 41 41 41 41 41 41 10
10 41 41 41 41 41 41 41 41 10
10 41 41 41 41 41 41 41 41 10
10 10 10 10 10 10 10 10 10 10